###############
#      #      #
# $$   #   .. #
#             #
### ##### ### #
#      #      #
# $    #    . #
#   @         #
###############
