############
#          #
#  #####   #
#       $  #
#  # $ #   #
# .      . #
#  #####   #
#      @   #
############
