#########
#   #   #
# $ # . #
#       #
# $   . #
#   #   #
#@  #   #
#########
